11 11
8 8 8 8 8 8 8 8 8 8 8 8 8 8 8 8 8 8 8 8 8 8 8
8 7 0 0 0 0 0 0 0 0 0 0 0 0 0 0 0 0 0 0 0 7 8
8 0 0 0 0 0 0 0 0 0 0 0 0 0 0 0 0 0 0 0 0 0 8
8 0 0 8 8 0 0 0 0 8 7 0 7 8 0 0 0 0 8 8 0 0 8
8 0 0 8 6 0 0 0 0 8 8 0 8 8 0 0 0 0 6 8 0 0 8
8 0 0 8 5 0 0 0 0 8 8 0 8 8 0 0 0 0 5 8 0 0 8
8 0 0 8 8 0 0 0 0 8 7 0 7 8 0 0 0 0 8 8 0 0 8
8 0 0 0 0 0 0 0 0 8 8 0 8 8 0 0 0 0 0 0 0 0 8
8 0 0 0 0 8 0 0 8 7 8 0 8 7 8 0 0 8 0 0 0 0 8
8 8 0 7 0 0 0 0 6 0 0 0 0 0 6 0 0 0 0 7 0 8 8
8 0 0 0 0 8 0 0 5 0 0 0 0 0 5 0 0 8 0 0 0 0 8
8 7 0 0 0 0 0 0 8 0 0 0 0 0 8 0 0 0 0 0 0 7 8
8 8 8 8 8 8 8 8 8 8 8 8 8 8 8 8 8 8 8 8 8 8 8
